****************************
*         *               E*
*  ***    *              ***
*    *    *              * *
*    *    *              * *
*    *    *              * *
*S   *    *              * *
*    *    * ******* ****** *
***  *    *                *
*    *    **************   *
*    *                     *    
****************************